11111111111111111111111111111111111111111111111111111
1E000000000000000011000000000C0000000000C000100010001
1010010100100000100100000100000000C000011000101010101
1010010010101010100001000100001100100001100010101C101
100000000C00C0000C1000000100001100000001C000101010101
1010010100100000100100000100000001C001000000101010101
101001001010101010001000010000C000001100000010101C101
1P0000000C00C0000C1000000100000001110000C0000010001C1
11111111111111111111111111111111111111111111111111111
