11111111111111111111111111111111111111111111111111111111111111111111111111111111
1P100010001000100010001000100010001000100010001000100010001000100010001000100011
1E0010001000100010001000100010001000100010001000100010001000100010001000100010C1
11111111111111111111111111111111111111111111111111111111111111111111111111111111