1111111111111
1E01110000001
1000C11111001
1P00010000001
1111111111111