1111111111111
1001110000001
1001C11111001
1P00E10000001
